24
*
15
*
3
*
01-3-1-0
#
03-0-0-0
#
02-1-1-1
#
00-2-0-0
*01 01 01 01 01 01 01 01 01 01 01 01 01 01 01 01 01 01 01 01 01 01 01 01
 01 01 01 01 01 01 01 01 01 01 01 01 01 01 01 01 01 01 01 01 01 01 01 01
 01 01 03 03 02 03 03 03 02 03 03 03 03 02 03 03 03 03 03 02 03 03 01 01
 01 01 03 03 02 03 02 03 03 03 03 02 02 03 03 03 03 02 03 02 03 03 01 01
 01 01 03 03 03 03 03 02 03 03 03 03 03 03 03 03 02 03 03 03 03 03 01 01
 01 01 03 02 03 03 03 03 03 03 02 03 03 02 03 03 03 03 03 03 02 03 01 01
 01 01 03 03 02 03 02 03 03 02 03 03 03 03 02 03 03 02 03 02 03 03 01 01
 01 01 03 03 03 03 03 02 03 02 03 03 03 03 02 03 02 03 03 03 03 03 01 01
 01 01 03 03 02 03 02 03 03 02 03 03 03 03 02 03 03 02 03 02 03 03 01 01
 01 01 03 02 03 03 03 03 03 03 02 03 03 02 03 03 03 03 03 03 02 03 01 01
 01 01 03 03 03 03 03 02 03 03 03 03 03 03 03 03 02 03 03 03 03 03 01 01
 01 01 03 03 02 03 02 03 03 03 03 02 02 03 03 03 03 02 03 02 03 03 01 01
 01 01 03 03 02 03 03 03 03 03 02 03 03 03 03 02 03 03 03 02 03 03 01 01
 01 01 01 01 01 01 01 01 01 01 01 01 01 01 01 01 01 01 01 01 01 01 01 01
 01 01 01 01 01 01 01 01 01 01 01 01 01 01 01 01 01 01 01 01 01 01 01 01