24
*
15
*
1
*
01-10-1-0
#
02-8-0-0
#
03-1-0-0
#
04-31-1-1
#
05-6-0-0
#
06-4-0-0
#
07-9-1-1
#
08-7-0-0
#
09-2-0-0
#
10-11-1-1
#
11-5-0-0
#
12-0-0-0
#
00-12-0-0
#
13-3-0-0
*01 01 01 01 01 01 01 01 01 01 01 01 01 01 01 01 01 01 01 01 01 01 01 01
 01 01 01 01 01 01 01 01 01 01 01 01 01 01 01 01 01 01 01 01 01 01 01 01
 01 01 02 03 03 03 03 04 03 04 04 04 04 04 04 03 04 03 03 03 03 05 01 01
 01 01 06 12 12 07 12 12 12 12 07 07 07 07 12 12 12 12 07 12 07 13 01 01
 01 01 06 12 12 07 12 07 07 12 12 12 12 12 12 07 07 12 07 12 12 13 01 01
 01 01 06 07 12 12 12 12 07 12 07 12 12 07 12 07 12 12 12 12 07 13 01 01
 01 01 06 12 12 07 12 07 12 12 12 07 07 12 12 12 07 12 07 12 12 13 01 01
 01 01 06 07 12 07 12 12 12 07 12 07 07 12 07 12 12 12 07 12 07 13 01 01
 01 01 06 12 12 07 12 07 12 12 12 07 07 12 12 12 07 12 07 12 12 13 01 01
 01 01 06 07 12 12 12 12 07 12 07 12 12 07 12 07 12 12 12 12 07 13 01 01
 01 01 06 12 12 07 12 07 07 12 12 12 12 12 12 07 07 12 07 12 12 13 01 01
 01 01 06 12 12 07 12 12 12 12 07 07 07 07 12 12 12 12 07 12 07 13 01 01
 01 01 08 09 09 09 09 10 10 10 10 10 10 10 10 09 10 09 09 09 09 11 01 01
 01 01 01 01 01 01 01 01 01 01 01 01 01 01 01 01 01 01 01 01 01 01 01 01
 01 01 01 01 01 01 01 01 01 01 01 01 01 01 01 01 01 01 01 01 01 01 01 01