24
*
15
*
2
*
01-7-1-0
#
07-0-0-0
#
02-1-1-1
#
03-2-0-0
#
04-3-0-0
#
05-4-0-0
#
06-5-0-0
#
00-6-0-0
*01 01 01 01 01 01 01 01 01 01 01 01 01 01 01 01 01 01 01 01 01 01 01 01
 01 01 01 01 01 01 01 01 01 01 01 01 01 01 01 01 01 01 01 01 01 01 01 01
 01 01 07 04 07 02 02 03 07 07 07 02 02 07 07 07 03 02 02 07 07 07 01 01
 01 01 07 02 07 07 07 07 07 07 07 02 02 07 04 07 07 07 07 05 02 07 01 01
 01 01 07 07 03 02 02 02 07 07 07 03 05 07 07 07 04 02 02 07 03 07 01 01
 01 01 07 04 07 07 04 07 07 07 07 07 07 07 07 07 07 07 07 07 07 07 01 01
 01 01 07 07 07 07 07 02 02 07 02 07 07 02 07 02 02 07 07 03 07 04 01 01
 01 01 07 02 02 02 07 03 07 07 02 03 07 02 07 07 07 07 02 02 06 07 01 01
 01 01 07 07 07 07 05 02 02 07 02 07 07 02 07 02 02 07 07 07 07 07 01 01
 01 01 03 07 07 03 07 07 07 07 04 07 07 07 07 07 07 05 07 07 07 07 01 01
 01 01 07 07 07 02 02 02 07 07 07 02 05 07 07 07 02 02 02 07 04 07 01 01
 01 01 07 02 05 07 05 07 07 05 07 02 02 07 07 07 07 07 07 07 02 07 01 01
 01 01 04 07 07 02 02 02 07 07 07 02 02 04 07 05 02 02 02 07 03 07 01 01
 01 01 01 01 01 01 01 01 01 01 01 01 01 01 01 01 01 01 01 01 01 01 01 01
 01 01 01 01 01 01 01 01 01 01 01 01 01 01 01 01 01 01 01 01 01 01 01 01